â€™
button - tugma
state - state
event - event
layout - layout
framework - freymvork
open source - ochiq manbali
Separation of concerns - vazifalarni ajratish
Single source of truth - Ma'lumotlarning markaziy boshqaruvi
status quo - o'sha paytdagi standard
curly braces - jingalak qavslar
maintain - davom ettirish
maintainability - davom ettiriluvchanlik
community - hamjamiyat
under the hood - ichki ishlash mexanizmi
string - satr
alternative - muqobil
engine - dvijok
bundle - to'plam paketi
syntax sugar - sodda sintaksis
runtime - kodni bajarilish vaqti
reconciliation - moslashtirish
expensive - ko'p(qo'shimcha) resurs talab qilish
batch update - to'plab yangilash
unique - takrorlanmas
advanced - ilg'or
scalable - kengayish, kengayuvchan
reusable components - qayta ishlatiladigan komponentlar
performance - ishlash samaradorligi
flicker - miltillash
responsive - moslashuvchan, javob beruvchan
Cross-browser compatibility - Brauzerlararo o'zaro mutanosiblik
core - negizi
dirty - ifloslangan
artifact - artifact
accessibility - foydalanish imkoniyati qulayligi
shallow comparison - yuzaki taqqoslash
dependency - bog'liqlik
event delegation - event delegation
lazy loading - kechiktirilgan yuklanish
cross-cutting concern - o'zaro bog'liq muammo
custom - moslashtirilgan
fallback - vaqtinchalik muqobil
hydration - hidratsiya
sensitive data - nozik ma'lumotlar
routing- routing